11111111111111111111111111111111111111
1E0000000000000C00000C0011010000000001
10100101001000001010010011010101000001
10100100101010100010010011010101000001
10100101001000001010010011010101000001
10100100101010100010010011010101000001
10100101001000001010010011010101000001
10100100101010100010010011010101000001
10100101001000001010010011010101000001
10100100101010100010010011010101000001
10100101001000001010010011010101000001
10100100101010100010010011010101000001
10100101001000001010010010010101000001
10100101001000001010010000000101000001
10100100101010100010010000000101000001
1P0000000C00C00000000000100100000000C1
11111111111111111111111111111111111111